11111111111111111111111111111
12000000000001110000000000021
10111101111101110111110111101
10111101111101110111110111101
10111101111101110111110111101
10000000000000000000000000001
10111101101111111110110111101
10111101101111111110110111101
10111101100001110000110111101
10000001111101110111110000001
11111101111101110111110111111
11111101100000000000110111111
11111101101110001110110111111
11111101101000000010110111111
11111101101000000010110111111
00000000001000000010000000000
11111101101000000010110111111
11111101101111111110110111111
11111101100000000000110111111
11111101101111111110110111111
11111101101111111110110111111
10000000000001110000000000001
10111101111101110111110111101
10111101111101110111110111101
10001100000000000000000110001
11101101101111111110110110111
11101101101111111110110110111
10000001100001110000110000001
10111111111101110111111111101
10111111111101110111111111101
12000000000000000000000000021
11111111111111111111111111111